3,0,0,0,0,0,0,0,0,0,0,0,0,0,0,0,0,0,0,0,0,0,0,0,0,0,0,0,0,0,0,0,0,0,0,0,0,0,0,0,0,0,0,0,0,0,0,0,0,0,0,0,0,0,3
5,0,0,0,0,0,0,0,0,0,0,0,0,0,0,0,0,0,0,0,0,0,0,0,0,0,0,0,0,0,0,0,0,0,0,0,0,0,0,0,0,0,0,0,0,0,0,0,0,0,0,0,0,0,5
5,0,0,0,0,0,0,0,0,0,0,0,0,0,0,0,0,0,0,0,0,0,0,0,0,0,0,0,0,0,0,0,0,0,0,0,0,0,0,0,0,0,0,0,0,0,0,0,0,0,0,0,0,0,5
5,0,0,0,0,0,0,0,0,0,0,0,0,0,0,0,0,0,0,0,0,0,0,0,0,0,0,0,0,0,0,0,0,0,0,0,0,0,0,0,0,0,0,0,0,0,0,0,0,0,0,0,0,0,5
5,0,7,7,7,0,0,0,7,7,7,7,0,0,7,0,0,7,0,7,0,7,0,0,7,0,7,0,0,7,7,0,0,0,0,7,0,7,0,7,0,0,7,0,0,7,0,0,7,0,0,7,0,0,5
5,0,2,3,4,0,0,0,2,3,4,0,0,0,2,3,4,0,0,0,2,3,4,0,0,0,0,0,2,3,4,0,0,0,2,3,4,0,0,0,2,3,4,0,0,0,2,3,4,0,0,0,0,0,5
5,0,0,0,0,0,0,0,0,0,0,0,1,0,0,0,0,0,6,6,6,6,6,0,6,0,0,0,0,0,6,6,6,0,0,0,0,0,0,6,6,6,0,0,6,0,6,0,6,0,0,0,0,0,5
5,3,3,3,3,3,3,3,3,3,3,3,3,3,3,3,3,3,3,3,3,3,3,3,3,3,3,3,3,3,3,3,3,3,3,3,3,3,3,3,3,3,3,3,3,3,3,3,3,3,3,3,3,3,5